        X     X       X      X   X   X  X      X  
XXXXXX  X     X   XX  X  X       X      XXXXX     
        XXX X      X    XXXXXXX  X   X  X      XXX
XXXX    X   XXXX   X     X       XX  XX    X      
  X   X X   X     XXXXXX X  XXX      XXXXXXX  X  X
  X  XX X XXX XXXXXX X   X    X XXX   XX      X  X
  XX  X X   X        XXXXXXX  X   XXXXXX      XXXX
      X     X   X    X        X     X       X     