        л     л       л      л   л   л  л      л  
лллллл  л     л   лл  л  л       л      ллллл     
        ллл л      л    ллллллл  л   л  л      ллл
лллл    л   лллл   л     л       лл  лл    л      
  л   л л   л     лллллл л  ллл      ллллллл  л  л
  л  лл л ллл лллллл л   л    л ллл   лл      л  л
  лл  л л   л        ллллллл  л   лллллл      лллл
      л     л   л    л        л     л       л     