 л  л     л     л  л       л  л       л     л     
 лл л  л  ллл   л  л   ллллл     ллл  л ллл л лллл
 л  ллллл ллл л лллллл  л    ллллл л  л   л     л 
    лллл  л   л л    л     л     л ллллл  лллл  л 
    л        лллллл  лллл  ллллл л л л    л     л 
лл     лллл  л   л         л  л  л   л  ллл   ллл 
    лллл         л ллллл  лл  лл лл  л лллллл  лл 
 л   л     л   л      л       л  л      л   л     