 #  #     #     #  #       #  #       #     #     
 ## #  #  ###   #  #   #####     ###  # ### # ####
 #  ##### ### # ######  #    ##### #  #   #     # 
    ####  #   # #    #     #     # #####  ####  # 
    #        ######  ####  ##### # # #    #     # 
##     ####  #   #         #  #  #   #  ###   ### 
    ####         # #####  ##  ## ##  # ######  ## 
 #   #     #   #      #       #  #      #   #     