 #         # # #        #  #       #  #   #  #    
 ## ##  #  #   #####    #  # #####    #      ###  
##   # ## ##   #  #   #    #        # #####  #   #
     #  #  # # #  #  ####  # #   #  # #      # ###
#### #  #    # #  # #####    # #### #     ####    
  #  #####   #   ## #  #     #  #   #  ####     # 
  #  #  #  ####  #  #     ####  ######   #  ##### 
        #    #      # #   #     #   #       #     