 л         л л л        л  л       л  л   л  л    
 лл лл  л  л   ллллл    л  л ллллл    л      ллл  
лл   л лл лл   л  л   л    л        л ллллл  л   л
     л  л  л л л  л  лллл  л л   л  л л      л ллл
лллл л  л    л л  л ллллл    л лллл л     лллл    
  л  ллллл   л   лл л  л     л  л   л  лллл     л 
  л  л  л  лллл  л  л     лллл  лллллл   л  ллллл 
        л    л      л л   л     л   л       л     