 #         # # #        #  #       #  #   #  #    
 ## ##  #  #   #####    #  # #####    #      ###  
 #   # ## ##   #  #   #    #        # #####  #   #
     #  #  # # #  #  ####  # #   #  # #      # ###
#### #  #    # #  # #####    # #### #     ####    
  #  ## ##   #   ## #  #     #  #   #  ####     # 
  #  #  #  ####  #  #     ####  # ####   #  ##### 
        #    #      # #   #     #   #       #     