  л  л    л         л     л   л  л  л       л     
 лл  л   лллл  л  л л  л  л   л  л  л      лл    л
  л лллл  л    л  л л  л    л    л      л   л    л
      л  лл ллллл л   лллл  л    л  лллллл  лл    
ллл л л   л  л л  лл       лллл       л        л  
 л  л л л л  л       ллл   лллл    л  л  лллл  лл 
 л лл   л   лллл ллл л   ллл     лллл лл  л    л  
    л   л    л     л л     л       л  л   л    л  