 л          л      л      л   л    л  л   л  л    
 л  ллл  лллл  ллллл  ллллл ллллл  л  л      ллллл
 л   л   л  л   л  л      л   л    л ллллл   л    
     л          л         л     лллл    л  ллл л  
ллл     ллллл   л лллллл  ллллл  л      л      л  
 л  л     л     л   л            л лллл л   ллллл 
 л  лллл  л   ллллл л  ллл  ллл     л   л л     л 
    л     л         л   л    л      л     л       