        л  л л      л   л    л  л   л     л    л  
 лллллл л  л л  ллллл   л   лл  л лллллл  л ллллл 
 л  л   л    л      л лллл   л  л л л          л  
 л  л       лллл  л л        л    л   л ллллл  л л
ллл ллллллл  л    л       лллллл  л  лл  ллллл л л
    л       лл  ллллллл лллл          л     л     
 л     лл  ллл   л   л    л   л ллллл ллллл л  л  
 л      л  л     л        л   л  л    л     л  л  
