          л        л            л     л        л  
ллл       л     лллл    ллллл лллл  лллллл   лллл 
  л  ллл  лллл  л  л  ллл  л        ллл л      л  
 ллл л     л    л       л  л    лл   л  л  л      
     л  ллллл   ллллл  лл лллл   л   л лл  л   ллл
 ллллл   л        л     л       лллл    л лллл л  
  л  л ллл  ллл  ллллл  ллллл   л  ллл    л  л л  
  л          л          л       л            л    