             #      #   #       #            #    
###     ### ###     # ###     ### #    #     ##   
  ##### #   #    ####   ###       #### ####  #  ##
  # #   # ###  ### #     #   ##   #  # #          
    #   #      #   #  ## #    ## ##  #### # ####  
 #  ##### #### #         ####  ###   #  # #  # ## 
 #        #      #####          #  ###  #### # #  
 #        #        #            #              #  