             #      #   #       #            #    
###     ### ###     # ###     ### #    #     ##   
  ##### #   #    ####   ###       #### ####  #  ##
  # #   # ###  ### #     #   ##   #  # #          
    #   #      #   #  ## #    ## ##  #### # ####  
 #  # ### #### #         ####  ###   #  # #  # ## 
 #        #      #####          #  ###  #### # #  
 #        #        #            #              #  