             л      л   л       л            л    
ллл     ллл ллл     л ллл     ллл л    л     лл   
  ллллл л   л    лллл   ллл       лллл лллл  л  лл
  л л   л ллл  ллл л     л   лл   л  л л          
    л   л      л   л  лл л    лл лл  лллл л лллл  
 л  ллллл лллл л         лллл  ллл   л  л л  л лл 
 л        л      ллллл          л  ллл  лллл л л  
 л        л        л            л              л  