 л      л          л    л       л     л л      л  
 л   л  л  лллл л  л  лллл   л  л  лллл л   ллллл 
 ллл лллл   л   лллл    л   ллллл       л    л л  
  л    л  ллл    л      ллл    ллллллл    лллл   л
  л    л    л    ллллл   л                   л л л
 лллл лллл лллл  л      ллллл лллл    л  л     л л
 л  л      л        ллл  л    л    лллл ллллл лл  
           л        л         л       л л      л  