 #      #          #    #       #     # #      #  
 #   #  #  #### #  #  ####   #  #  #### #   ##### 
 ### ####   #   ####    #   #####       #    # #  
  #    #  ###    #      ###    #######    ####   #
  #    #    #    #####   #                   # # #
 #### #### ####  #      ##### ####    #  #     # #
 #  #      #        ###  #    #    #### ##### ##  
           #        #         #       # #      #  