        #     #       #      #   #   #  #      #  
######  #     #   ##  #  #       #      #####     
        ### #      #    #######  #   #  #      ###
####    #   ####   #     #       ##  ##    #      
  #   # #   #     ###### #  ###      #######  #  #
  #  ## # ### ###### #   #    # ###   ##      #  #
  ##  # #   #        #######  #   ######      ####
      #     #   #    #        #     #       #     