 #         # # #        #  #       #  #   #  #    
 ## ##  #  #   #####    #  # #####    #      ###  
 #   # ## ##   #  #   #    #        # #####  #   #
     #  #  # # #  #  ####  # #   #  # #      # ###
#### #  #    # #  # #####    # #### #     ####    
  #  #####   #   ## #  #     #  #   #  ####     # 
  #  #  #  ####  #  #     ####  ######   #  ##### 
        #    #      # #   #     #   #       #     