  #  #    #         #     #   #  #  #       #     
 ##  #   ####  #  # #  #  #   #  #  #      ##    #
  # ####  #    #  # #  #    #    #      #   #    #
      #  ## ##### #   ####  #    #  ######  ##    
### # #   #  # #  ##       ####       #        #  
 #  # # # #  #       ###   ####    #  #  ####  ## 
 # ##   #   #### ### #   ###     #### ##  #    #  
    #   #    #     # #     #       #  #   #    #  