 #          #      #      #   #    #  #   #  #    
 #  ###  ####  #####  ##### #####  #  #      #### 
 #   #   #  #   #  #      #   #    # #####   #    
     #          #         #     ####    #  ### #  
###     #####   # ######  #####  #      #      #  
 #  #     #     #   #            # #### #   ##### 
 #  ####  #   ##### #  ###  ###     #   # #     # 
    #     #         #   #    #      #     #       