        #  # #      #   #    #  #   #     #    #  
 ###### #  # #  #####   #   ##  # ######  # ##### 
 #  #   #    #      # ####   #  # # #          #  
 #  #       ####  # #        #    #   # #####  # #
### #######  #    #       ######  #  ##  ##### # #
    #       ##  ####### ####          #     #     
 #     ##  ###   #   #    #   # ##### ##### #  #  
 #      #  #     #        #   #  #    #     #  #  