          #        #            #     #        #  
###       #     ####    ##### ####  ######   #### 
  #  ###  ####  #  #  ###  #        ### #      #  
 ### #     #    #       #  #    ##   #  #  #      
     #  #####   #####  ## ####   #   # ##  #   ###
 #####   #        #     #       ####    # #### #  
  #  # ###  ###  #####  #####   #  ###    #  # #  
  #          #          #       #            #    